F 0, 178,             255

SO textures/colorstone.xpm
EA textures/cobblestone_gray.xpm
NO textures/blue_stone.xpm
WE textures/redbrick.xpm
C      0, 55,255

11111111111111111
10000000000000001
10100000100000101     111111111111111111111
10000000000000001      10001000100010001
10000000000000001      10001000100010001
10000000000000001      10001000100010001
10000000000000001      10001000100010001
10000000000100001      10001000100010001
10000000000010001      10001000100010001
10000000000000001      10001000100010001
10000000000000001      10001000100010001
10000W000000000011111111100010001000100011111111111111111111111111
100000000000000000000000100000000000000000000000000000000000000001
10000000000000000000000111000000000000000000000000000000000000001
10000000000000000000000010000000000000000000000000000000000000001
11111111110000000000000000000000000000000000011111111111111111111
110000000000000000000000000000011111111111111
1000000000000000000000001011011
1000100010010001011111000111111
1000000000000000100000000000001
1010000010000100111111111111111
10000000000000001
10001000100100001
10000000000000001
10100000100001001
10000000001110001
1111111111111111
